111111111111111111111111111777711117777111111111111111111111111111111111111111111111111111111111111177777777777777777777777777777777777777777777777777777777777777777777111111111111111111111
000000000000000000000007777000077770000777700000000000000000000077777777777770000000000000000000077700000000000000000000000000000000000000000000000000000000000000000111000000000000000000000
000000000000000000000007777000077770000777700000000000000000000077777777777770000000000000000000077700000000000000000000000077770000000000000000000000000000000000000111000000000000000000000
000000000000000000000000000000077770000777700007777777777777000077777777777770000000077777000000077700000000007777000000000077770000000000000000000000000000777770000111000000000000000000000
000000000000000000000000000000077770000777700007777777777777000077777777777770000000077777000000077700007777007777007777000000000000000000000000000000000000111110000111000000000000000000000
000000000000000000000000000000000000000777700007777777777777000077777777777770000000077777000000077700007777000000007777000000000000000000000000000000077770111110000111000000000000000000000
000000000000000000000000000000000000000000000007777777777777000000000001111110000000077777000000077700000000000000000000000000000000000000000000000000077770111110000111000000000000000000000
000000000000000000000000000000000000000000000007777777777777000000000001111110000000077777000011111100000000000000000000000000000000000000000000777700000000111110000111000000000000000000000
000000000000000000000000000000000000000000000007777777777777000077770000000770000000077777000011111100000000000000000000000000000000777700000000777700000000111110000111000000000000000000000
000000000000000000000000000000000007777000000007777777777777000077770000000770000000077777000000000000000000000000000000000000000000777700000000000000000000111110000111000000000000000000000
000000000000000000000000000777700007777000000007777777777777000011111111000000000000077777000000000000007777000000000000000000000000000000777700000000000000111110000111000000000000000000000
000000000000000000077770000777700007777000000007777777777777000011111111000000000000000000000000000000007777000000000000000000000000000000777700000000000000111110000000000000000000000000000
000000000000000000077770000777700007777000000007777777777777000077777777777770000000000000000000000000007777000000000000000000000000000000000000000000000000111110000000000000000000000000000
111111111111111111111117777111177771111111111111111111111111111111111111111111111111177777111177777711117777111111111111111111111111111111111111111111111111777777777777777777777777777777777
